der Reis - ryż
die Krankschreibung - zwolnienie lekarskie
zum Leben zurückkommen - wrócić do życia
auf dem Laufenden sein - być na bieżąco
nach dem Unterricht - po lekcji
ein weich / hart gekochtes Ei - jajko na twardo / miękko
das Fitnessstudio - siłownia
entschieden - zdecydowany
Urlaub machen
Wen - kiedy
der Pilz, -e - grzyb
Pilze sammeln - zbierać grzyby
der Pilzsammler - grzybiarz
trocken - suszyć
das Weihnachten - Boże Narodzenie
der Heiligabend - Wigilia
das Eingemachte - przetwory
die Ernte, -n - zbiór
abhängen von +Dat. - zależeć od czegoś/kogoś
das Wetter - pogoda
erwachsen - dorosły
finden - znajdować
langweilig - nudny
nervig - irytujący, denerwujący
werden - stać się
Ich bin dessen nicht sicher. - Nie jestem tego pewien.
besonders
etwas / nichts Besonderes
Wen - kogo
das Abendkleid, -er - suknia wieczorowa 
das Lied, -er - piosenka
das Schiff, -e - statek, okręt
der Fluss, Flüsse - rzeka
der Hafen, Häfen - port, przystań
die Brücke, -n - most
farbig - kolorowy
bestimmt - określony, uzgodniony, na pewno, z pewnością
die Bahn - kolej
das Bett - łóżko
der Stuhl - krzesło
der Sessel - fotel
das Ostern - Wielkanoc
bereuen - żałować
normalerweise - normalnie
in Rente sein - być na emeryturze
Ich kann es kaum erwarten. - Nie mogę się doczekać.
wahrscheinlich - prawdopodobnie
bei Vorbereitungen helfen - pomagać w przygotowaniach
die Zeitung - gazeta
je nachdem - zależy
auf +Akk. ankommen - zależeć od kogoś/czegoś
spät - późno
jeder - każdy
die Pflaume, -n - śliwka
letztens - ostatnio
die Kräuter - zioła
das Getränk, -e - napój
ein bisschen - trochę
der Quark - twaróg
das Spiegelei, -er - jajko sadzone
ein weich / hart gekochtes Ei - jajko na miękko / twardo
das Rührei - jajecznica
die Brust, Brüste - pierś
gebraten - smażony
ein paar - kilka
der Preis, -e - cena
der Verkäufer - sprzedawca

