die Familie - rodzina
das Sentiment - sentyment
alle zwei Monate - ~ co dwa miesiące
ins Ausland - za granicę
die Gelegenheit, -en - okazja
wunderbar - cudownie, cudowny
dort - tam (popatrzeć na przykład zdania)
der Ort, -e - miejsce
das Gedächtnis, -se - pamięć
letztes Jahr - w ostatnim roku
versuchen - próbować
ich war … - byłem …
stark - silny
geschlossen - zamknięty
der Wind - wiatr
der Turm - wieża
der Fernsehturm 
vielleicht - może
übersetzen - przetłumaczyć
am Anfang - na początku
breit - szeroki
sicher - pewny
der Grund, Gründe - powód
nennen - wymieniać, podawać, nazywać
der Hörtext, -e - nagranie, słuchanka
es ist sehr nett - to bardzo miłe
nichts - nic
niemand - nikt, żaden, ani jeden
sondern - lecz
der Nachbar - sąsiad
moderne Malerei - współczesne malarstwo
davon - z tego (davon verstehe ich…), o tym
der Durst - pragnienie
der Mensch - człowiek
der Laptop
das Dach - dach xD
die Angst - strach
tut mir leid - przykro mi
der Kuli - długopis
das Englisch - język angielski
der Comic, -s - komiks
das Büro, -s - biuro
zeichnen - rysować
das Zeichnen - rysunek, rysowanie
das Haustier, -e - zwierzę domowe
der Nachbar, -n - sąsiad
die Kundin, -nen - klientka
der Kunde, -en - klient
die Lampe - lampa
der Alkohol, -e - alkohol
ganz - całkowicie, zupełnie
gar - wcale, zupełnie
überhaupt - zupełnie, właściwie, w ogóle
gerade - właśnie 
kennen - znać
sich kennen - znać się
hungrig - głodny
glücklich - szczęśliwy
spannend - ciekawy, zajmujący, wciągający
interessant - interesujący, ciekawy
nicht mehr - już nie, więcej nie
niemals - nigdy
nirgends - nigdzie
Auf keinen Fall - w żadnym razie
der Fall - upadek, przypadek, przypadek gramatyczny
das Studium - studia
der Sprachschatz - słownictwo, zasób słownictwa
die Allergie - alergia
der  Blick - widok
registrieren - rejestrować
der Fehler - błąd 
nachdenken, bedenken - zastanawiać się, rozmyślać
erklären - wytłumaczyć, tłumaczyć (zagadnienie)
reiten - dosiadać
der Zaum - uzda (końska)
umfassen, einfangen - chwycić
bewegen - ruszyć, poruszyć
losgehen - ruszyć, startować, zaczynać
ruhig - spokojny, stonowany
der Gang - chód, krok
wachsen - rosnąć
die Blume - kwiat
begießen - podlewać
gießen - podlać
die Verletzung - uraz, kontuzja, rana
die Wunde, -n - rana
der Bruch - złamanie
brechen - złamać
die Tastatur - klawiatura
beleuchten - podświetlać, oświetlać
beleuchtet - podświetlony
