definitiv - zdecydowanie, definitywnie
Spaß haben - have fun
das Brettspiel, -e - planszówka
Bücher lesen - czytać książki
empfehlen - polecać
die Süßigkeiten - słodycze
kochen - gotować
die Speise, -n - potrawa
brauchen - potrzebować
jetzt - teraz
die Eltern
alt - älter - am ältesten
der Monat, -e
ferne Flüge
es gibt wenige Aktivitäten
der Bus
jeden Tag
circa
wählen - wybrać
beenden
tanzen
du tanzt
das Glas
der Stift, -e
faulenzen - próżnować, leniuchować
mischen - mieszać
besichtigen - zwiedzać
wissen - wiedzieć
die Wahl - wybór
zu viert - w czwórkę
teuer - drogi, drogo
die Fluggesellschaft, -en - linia lotnicza
wechseln - zmieniać
verschieben - przesunąć
bestellen - zamawiać
meistens - zazwyczaj
morgen - jutro
bekommen - otrzymywać, dostawać
schicken - wysłać, posyłać
die Frau - Pani, kobieta
der Mann - mężczyzna
gefallen - podobać się
tragen - nosić
waschen - myć, prać
geben - dawać
helfen - pomagać
nehmen - brać
leise - cichy, cicho
sicher - pewny, bezpieczny, pewnie
vergessen - zapominać
schlecht - zły, niedobry, marny
deshalb - dlatego
die Brille - okulary
