nutzen - używać
besprechen - omawiać
demselben - temu samemu
derselbe - ten sam
halten - trzymać
Niemand ist da - nikogo nie ma
ohne Grund - bez powodu
der Grund, Gründe - powód
Zeit verbringen - spędzać czas
das Eis (tylko liczba pojedyncza) - lód
klettern - wspinać się
bewundern - podziwiać
sich sonnen - opalać się
frische Luft einatmen - oddychać świeżym powietrzem
klug - mądry
gesellig - towarzyski 
so lala - tak sobie
die Wohnung, -en - mieszkanie
umziehen - przeprowadzić się
zuerst - najpierw
Ich habe nichts mehr zu sagen - nie mam nic wiecej do powiedzenia
der Geschmack - smak
Ich mag den Kaffeegeschmack nicht - nie lubie smaku kawy
gelegentlich - okazjonalnie
der Schnee - śnieg
unangenehm - nieprzyjemny
nicht zu warm, nicht zu kalt
ideal - idealny
wichtig - ważny
vor allem - głównie, przede wszystkim
zum Nachdenken zwingen - zmuszac do przemyslen
zwingen - zmuszac
