der Unterricht - zajęcia
einkaufen - robić zakupy
ich gehe einkaufen - idę na zakupy
die Frage, -n - pytanie
draußen - na zewnątrz
vor 2 Wochen - 2 tygodnie temu
in 2 Wochen - za 2 tygodnie
Was für Filme magst du? - Jakiego rodzaju filmu lubisz?
der Schauspieler - aktor
benutzen - używać
meistens - zwykle
ein paar - kilka
am letzten Montag - w ostatni poniedziałek
dieses Jahr
schwierig - trudny
(un)möglich - (nie)możliwe
die Sekunde, -n
Angst haben - bać się
verlieren - zgubić
auf jeden Fall - w każdy razie
die Gewohnheit, -en - nawyk
Inliner fahren - jeździć na rolkach
ob - czy // Można zacząć od tego pytanie? Ob …, czy po prostu tylko inwersja?
oder - albo
zwischendrin - w między czasie
Ich kann mich nicht genau erinnern. - Nie pamiętam dokładnie.
einen Termin vereinbaren - umówić termin
Ich habe nicht genau gehört. - Nie usłyszałem dokładnie.
nennen - nazywać, wymieniać, podawać
Bis dann! - na razie!
Arbeiten Sie zu dritt - pracujcie w trójkach
das Personalpronomen - zaimek osobowy
die Form, Formen - forma (np. czasownika, ale chyba też “fizyczna”), kształt
andere - inny, inna, inne
ander - inny, drugi
Ergänzen - uzupełniać
die Endung, Endungen - końcówka
der Beruf
passen - pasować, dobrze, leżeć
passen zu - pasować do
das Geld, Gelder (?) - pieniądze
die Straße - droga, ulica
das Glas - szklanka, słoik, kieliszek,
das Stift, Stifte - ołówek, pisak,
der Computer
das Medikament - lekarstwo, medykament
die Rechnung - rachunek
der Schlüssel, Schlüssel - klucz
die Spritze - strzykawka
die Tablette, -n - tabletka 
ordnen - porządkować, przyporządkować
die Ärztin - lekarka
die Arzt - lekarz
der Kellner
die Studentin, -tinnen - studentka
der Artikel - artykuł (gazeta), artykuł (w sklepie), produkt, rodzajnik
die Möglichket - możliwość
mehrere - kilka, wiele
die Nomen, Nomina - rzeczownik
die Tabelle
der Vergleich, -e - porównanie
von Montag bis Freitag
der Nachmittag
frei haben - mieć wolne
das Netzwerk, Netzwerke - sieć (komputerowa też)
die Leute - ludzie
verbinden - łączyć, połączyć, chyba też opatrywać
richtig - prawdziwy, prawidłowy, poprawny, naprawdę
kreuzen - krzyżować, stawiać krzyżyk
das Kreuz, -e - krzyż
Wer - kto
wirklich - naprawdę, rzeczywiście, prawdziwy, rzeczywisty
der Satz, Sätze - zdanie, stopa
das Zimmer
die Zahl, -en - liczba
zahlen - płacić
zählen - liczyć, obejmować (grupa), liczyć się
der Würfel, -n, - kostka, sześcian
die Aufgabe - zadanie, funkcja
etwas aufgeben - zrezygnować z czegoś
bedeuten - znaczyć
die Bedeutung - znaczenie
kopieren - kopiować
das Wörterbuch - słownik
das Lexikon - —//—
das Brettspiel - gra planszowa
